2 13 31
###############################
#p   *      s *  ** * *  4   *#
# # # # #*# # #*# # # # # #*# #
# x  f * *** **      *    **  #
# #*# # # # # # #b# # # # # #*#
#          *     **   s  *  **#
# #  *# # # # # #*#*#*#*# # # #
#   *        b   b *s* *  4   #
# # # # #*# # # # # # #*# #*# #
#   ***f         *  3         #
# # # # # # # # # #*# # # # #*#
#  ** *   *                   #
###############################